 ■ ■ ■ ■ ■ ■ ■ ■ ■ ■ ■ ■ ■ ■ ■ ■ ■ ■ ■ ■ ■ ■ ■ ■ ■ ■ ■ ■ ■ ■ ■ ■ ■ ■ ■ ■ ■ ■ ■ ■ ■ ■ ■ ■ ■ ■ ■ ■ ■ ■ ■ ■
 ■ + + + + + + + + + + + . + + + + + + + + + + . + + + + + + + + + + + + + . + + + + + + + + + + + + + ■
 ■ + + + + + + + + + + + . + +                 . + + + + + + + + + + + + + .                     + + + ■
 ■ + + +             + + . + +                 . + +                       .                     + + + ■
 ■ + + +             + + . + +                 . + +                       .                     + + + ■
 ■ + + +                                         + +                                             + + + ■
 ■ + + +                                         + +                                             + + + ■
 ■ + + +             + + . + +                                             .                     + + + ■
 ■ + + + + +     + + + + . + +                                             .                     + + + ■
 ■ + + + + +     + + + + . + +                 . + +                       .                     + + + ■
 ■ . . . .       . . . . . + + + + +     + + + . + +                       . + + + +     + + + + + + + ■
 ■ + + + +     + + + + + . . . . .       . . . . + +                       . . . . .       . . . . . . ■
 ■ +                 + + . + + + +       + + + . . . . . .         . . . . . + + + +       + + + + + + ■
 ■ +                 + + . +               + + .                         + . + + + + +     + + + + + + ■
 ■ +                 + + . +               + + .                         + .                       + + ■
 ■ +                 + + . +               + + .                         + .                       + + ■
 ■ +                       +               + + .                         + .                       + + ■
 ■ +                                                                     + .                       + + ■
 ■ +                 +                                                   + .                       + + ■
 ■ +                 + + . +               + + .                         + .                       + + ■
 ■ +                 + + . +               + + .                         + .                       + + ■
 ■ +                 + + . +               + + .                         + .                       + + ■
 ■ + + + + + + + + + + + . + + + +     + + + + .                         + . + + + + + + + + + + + + + ■
 ■ + + + + + + + + + + + . + + + +     + + + + . . . . . .     . . . . . . . . . . .     . . . . . . . ■
 ■ . . . . . . . . . . . . . . . .     . . . . . + +                 . + + + + + + +     + + + + + + + ■
 ■ + + + + + + + + + + . + + + + +     + + + + . + +                 .                               + ■
 ■ + + + + + + + + + + . + + + + +     + + + + . + +                 .                               + ■
 ■ +               + + . +                   + . + +                 .                               + ■
 ■ +               + + . +                   + . + +                                                 + ■
 ■ +               + + . +                   + . + +                                                 + ■
 ■ +               + + . +                   +                       .                               + ■
 ■ +               + + . +                                           .                               + ■
 ■ +               + + . +                       + +                 .                               + ■
 ■ +               + + . +                   + . + +                 . + + + + + +       + + + + + + + ■
 ■ +               + + . +                   + . + +                 . + + + + + +       + + + + + + + ■
 ■ +               + + . +                   + . + +                 . . . . . . .       . . . . . . . ■
 ■ + + + +     + + + + . +                   + . + +                 . +                         + + + ■
 ■ . . . .       . . . . + + + +       + + + + . . . . .       . . . . +                         + + + ■
 ■ + + + + +     + + + . . . . .       . . . . . + + + +     + + + + . +                         + + + ■
 ■ + + + + +     + + + .                   + + .                   + . +                         + + + ■
 ■ + +                 .                   + + .                   + . +                         + + + ■
 ■ + +                 .                   + + .                                                 + + + ■
 ■ + +                 .                   + + .                                                 + + + ■
 ■ + +                                     + + .                   + . +                         + + + ■
 ■ + +                                     + + .                   + . +                         + + + ■
 ■ + +                 .                   + + .                   + . +                         + + + ■
 ■ + +                 .                   + + .                   + . +                         + + + ■
 ■ + +                 .                   + + .                   + . +                         + + + ■
 ■ + +                 . + + + + + + + + + + + .                   + . + + + + + + + + + + + + + + + + ■
 ■ + +                 . + + + + + + + + + + + .                   + . + + + + + + + + + + + + + + + + ■
 ■ + + + + + + + + + + . + + + + + + + + + + + . + + + + + + + + + + . + + + + + + + + + + + + + + + + ■
 ■ ■ ■ ■ ■ ■ ■ ■ ■ ■ ■ ■ ■ ■ ■ ■ ■ ■ ■ ■ ■ ■ ■ ■ ■ ■ ■ ■ ■ ■ ■ ■ ■ ■ ■ ■ ■ ■ ■ ■ ■ ■ ■ ■ ■ ■ ■ ■ ■ ■ ■ ■
